assets/textures/tile_01.png
-120,0,1,96,240,24,24,0,0,0,0
-96,0,1,96,240,24,24,0,0,0,0
-72,0,1,96,240,24,24,0,0,0,0
-48,0,1,96,240,24,24,0,0,0,0
-24,0,1,96,240,24,24,0,0,0,0
0,0,1,96,240,24,24,0,0,0,0
24,0,1,96,240,24,24,0,0,0,0
48,0,1,96,240,24,24,0,0,0,0
72,0,1,96,240,24,24,0,0,0,0
96,0,1,96,240,24,24,0,0,0,0
120,0,1,96,240,24,24,0,0,0,0
120,24,1,96,240,24,24,0,0,0,0
96,24,1,96,240,24,24,0,0,0,0
72,24,1,96,240,24,24,0,0,0,0
48,24,1,96,240,24,24,0,0,0,0
24,24,1,96,240,24,24,0,0,0,0
0,24,1,96,240,24,24,0,0,0,0
-24,24,1,96,240,24,24,0,0,0,0
-48,24,1,96,240,24,24,0,0,0,0
-72,24,1,96,240,24,24,0,0,0,0
-96,24,1,96,240,24,24,0,0,0,0
-120,24,1,96,240,24,24,0,0,0,0
-144,24,1,96,240,24,24,0,0,0,0
-120,48,1,96,240,24,24,0,0,0,0
96,48,1,96,240,24,24,0,0,0,0
120,48,1,96,240,24,24,0,0,0,0
144,48,1,96,240,24,24,0,0,0,1
144,24,1,96,240,24,24,0,0,0,1
144,0,1,96,240,24,24,0,0,0,1
-168,0,1,96,240,24,24,0,0,1,0
-144,0,1,96,240,24,24,0,0,0,0
-144,48,1,96,240,24,24,0,0,0,0
-168,24,1,96,240,24,24,0,0,1,0
-168,48,1,96,240,24,24,0,0,1,0
-120,-24,1,144,216,24,24,0,0,0,0
-96,-24,1,144,216,24,24,0,0,0,0
-72,-24,1,144,216,24,24,0,0,0,0
-48,-24,1,144,216,24,24,0,0,0,0
-24,-24,1,144,216,24,24,0,0,0,0
0,-24,1,144,216,24,24,0,0,0,0
24,-24,1,144,216,24,24,0,0,0,0
48,-24,1,144,216,24,24,0,0,0,0
72,-24,1,144,216,24,24,0,0,0,0
96,-24,1,144,216,24,24,0,0,0,0
120,-24,1,144,216,24,24,0,0,0,0
-144,-24,1,144,216,24,24,0,0,0,0
-168,-24,1,120,216,24,24,0,0,1,0
144,-24,1,168,216,24,24,0,0,0,1
-168,-48,1,120,240,24,24,0,0,1,0
144,-48,1,168,240,24,24,0,0,0,1
-144,-48,1,144,240,24,24,0,0,0,0
-120,-48,1,144,240,24,24,0,0,0,0
-96,-48,1,144,240,24,24,0,0,0,0
-72,-48,1,144,240,24,24,0,0,0,0
-48,-48,1,144,240,24,24,0,0,0,0
-24,-48,1,144,240,24,24,0,0,0,0
0,-48,1,144,240,24,24,0,0,0,0
24,-48,1,144,240,24,24,0,0,0,0
48,-48,1,144,240,24,24,0,0,0,0
72,-48,1,144,240,24,24,0,0,0,0
96,-48,1,144,240,24,24,0,0,0,0
120,-48,1,144,240,24,24,0,0,0,0
-168,-72,1,120,264,24,24,0,0,1,0
144,-72,1,168,264,24,24,0,0,0,1
-144,-72,1,144,264,24,24,0,0,0,0
-120,-72,1,144,264,24,24,0,0,0,0
-96,-72,1,144,264,24,24,0,0,0,0
-72,-72,1,144,264,24,24,0,0,0,0
-48,-72,1,144,264,24,24,0,0,0,0
-24,-72,1,144,264,24,24,0,0,0,0
0,-72,1,144,264,24,24,0,0,0,0
24,-72,1,144,264,24,24,0,0,0,0
48,-72,1,144,264,24,24,0,0,0,0
72,-72,1,144,264,24,24,0,0,0,0
96,-72,1,144,264,24,24,0,0,0,0
120,-72,1,144,264,24,24,0,0,0,0
-144,-96,1,144,288,24,24,0,0,0,0
-120,-96,1,144,288,24,24,0,0,0,0
-96,-96,1,144,288,24,24,0,0,0,0
-72,-96,1,144,288,24,24,0,0,0,0
-48,-96,1,144,288,24,24,0,0,0,0
-24,-96,1,144,288,24,24,0,0,0,0
0,-96,1,144,288,24,24,0,0,0,0
24,-96,1,144,288,24,24,0,0,0,0
48,-96,1,144,288,24,24,0,0,0,0
72,-96,1,144,288,24,24,0,0,0,0
96,-96,1,144,288,24,24,0,0,0,0
120,-96,1,144,288,24,24,0,0,0,0
-168,-96,1,120,288,24,24,0,0,1,0
144,-96,1,168,288,24,24,0,0,0,1
-144,-120,1,144,312,24,24,1,0,0,0
-120,-120,1,144,312,24,24,1,0,0,0
-96,-120,1,144,312,24,24,1,0,0,0
-72,-120,1,144,312,24,24,1,0,0,0
-48,-120,1,144,312,24,24,1,0,0,0
-24,-120,1,144,312,24,24,1,0,0,0
0,-120,1,144,312,24,24,1,0,0,0
24,-120,1,144,312,24,24,1,0,0,0
48,-120,1,144,312,24,24,1,0,0,0
72,-120,1,144,312,24,24,1,0,0,0
96,-120,1,144,312,24,24,1,0,0,0
120,-120,1,144,312,24,24,1,0,0,0
-168,-120,1,120,312,24,24,1,0,1,0
144,-120,1,168,312,24,24,1,0,0,1
-72,48,1,72,312,24,24,0,0,0,0
-48,48,1,72,312,24,24,0,0,0,0
-24,48,1,72,312,24,24,0,0,0,0
0,48,1,72,312,24,24,0,0,0,0
24,48,1,72,312,24,24,0,0,0,0
48,48,1,72,312,24,24,0,0,0,0
-96,72,1,48,288,24,24,0,0,0,0
-72,96,1,72,264,24,24,0,0,0,0
-48,96,1,72,264,24,24,0,0,0,0
-24,96,1,72,264,24,24,0,0,0,0
0,96,1,72,264,24,24,0,0,0,0
24,96,1,72,264,24,24,0,0,0,0
48,96,1,72,264,24,24,0,0,0,0
72,72,1,96,288,24,24,0,0,0,0
-96,96,1,48,264,24,24,0,0,0,0
-96,48,1,48,312,24,24,0,0,0,0
72,48,1,96,312,24,24,0,0,0,0
72,96,1,96,264,24,24,0,0,0,0
-48,72,1,72,288,24,24,0,0,0,0
-24,72,1,72,288,24,24,0,0,0,0
24,72,1,72,288,24,24,0,0,0,0
-168,72,1,96,240,24,24,0,0,1,0
-144,72,1,96,240,24,24,0,0,0,0
-120,72,1,96,240,24,24,0,0,0,0
-120,96,1,96,240,24,24,0,0,0,0
-144,96,1,96,240,24,24,0,0,0,0
-168,96,1,96,240,24,24,0,0,1,0
-120,120,1,96,240,24,24,0,1,0,0
-96,120,1,96,240,24,24,0,1,0,0
-72,120,1,96,240,24,24,0,1,0,0
-144,120,1,96,240,24,24,0,1,0,0
-168,120,1,96,240,24,24,0,1,1,0
-48,120,1,96,240,24,24,0,1,0,0
-24,120,1,96,240,24,24,0,1,0,0
0,120,1,96,240,24,24,0,1,0,0
24,120,1,96,240,24,24,0,1,0,0
48,120,1,96,240,24,24,0,1,0,0
72,120,1,96,240,24,24,0,1,0,0
96,120,1,96,240,24,24,0,1,0,0
96,96,1,96,240,24,24,0,0,0,0
120,96,1,96,240,24,24,0,0,0,0
144,96,1,96,240,24,24,0,0,0,1
144,72,1,96,240,24,24,0,0,0,1
120,72,1,96,240,24,24,0,0,0,0
96,72,1,96,240,24,24,0,0,0,0
120,120,1,96,240,24,24,0,1,0,0
144,120,1,96,240,24,24,0,1,0,1
-72,72,1,24,312,24,24,0,0,0,0
0,72,1,24,312,24,24,0,0,0,0
48,72,1,24,312,24,24,0,0,0,0
