assets/textures/tile_01.png
0,-72
72,-168,1,96,240,24,24,1,1,0,0
48,-168,1,96,240,24,24,1,1,0,0
24,-168,1,96,240,24,24,1,1,0,0
0,-168,1,96,240,24,24,1,1,0,0
-24,-168,1,96,240,24,24,1,1,0,0
-48,-168,1,96,240,24,24,1,1,0,0
-48,-144,1,96,240,24,24,0,0,0,0
-72,-144,1,96,240,24,24,0,0,0,0
-96,-144,1,96,240,24,24,0,0,1,1
-96,-120,1,96,240,24,24,0,0,1,1
-96,-96,1,96,240,24,24,0,0,1,1
-96,-72,1,96,240,24,24,0,0,1,1
-96,-48,1,96,240,24,24,0,0,1,1
-72,-48,1,96,240,24,24,0,0,0,0
-24,-144,1,96,240,24,24,0,0,0,0
-72,-120,1,96,240,24,24,0,0,0,0
-72,-96,1,96,240,24,24,0,0,0,0
-72,-72,1,96,240,24,24,0,0,0,0
0,-144,1,96,240,24,24,0,0,0,0
48,-144,1,96,240,24,24,0,0,0,0
72,-144,1,96,240,24,24,0,0,0,0
24,-144,1,96,240,24,24,0,0,0,0
96,-96,1,96,240,24,24,0,0,0,0
96,-120,1,96,240,24,24,0,0,0,0
96,-144,1,96,240,24,24,0,0,0,0
96,-72,1,96,240,24,24,0,0,0,0
96,-48,1,96,240,24,24,0,0,0,0
-72,-24,1,96,240,24,24,0,0,0,0
-24,0,1,96,240,24,24,0,0,0,0
0,0,1,96,240,24,24,0,0,0,0
24,0,1,96,240,24,24,0,0,0,0
48,0,1,96,240,24,24,0,0,0,0
72,0,1,96,240,24,24,0,0,0,0
72,24,1,96,240,24,24,1,1,0,0
96,24,1,96,240,24,24,1,1,0,0
120,24,1,96,240,24,24,0,1,0,1
96,0,1,96,240,24,24,0,0,0,0
120,0,1,96,240,24,24,0,0,1,1
96,-24,1,96,240,24,24,0,0,0,0
120,-144,1,96,240,24,24,0,0,1,1
120,-120,1,96,240,24,24,0,0,1,1
120,-96,1,96,240,24,24,0,0,1,1
120,-72,1,96,240,24,24,0,0,1,1
120,-48,1,96,240,24,24,0,0,1,1
120,-24,1,96,240,24,24,0,0,1,1
48,24,1,96,240,24,24,1,1,0,0
24,24,1,96,240,24,24,1,1,0,0
0,24,1,96,240,24,24,1,1,0,0
-24,24,1,96,240,24,24,1,1,0,0
-48,24,1,96,240,24,24,1,1,0,0
-72,24,1,96,240,24,24,1,1,0,0
-96,24,1,96,240,24,24,0,1,1,0
-96,0,1,96,240,24,24,0,0,1,1
-96,-24,1,96,240,24,24,0,0,1,1
-72,0,1,96,240,24,24,0,0,0,0
-96,-168,1,96,240,24,24,1,0,1,0
-72,-168,1,96,240,24,24,1,1,0,0
96,-168,1,96,240,24,24,1,1,0,0
120,-168,1,96,240,24,24,1,0,0,1
-48,-120,1,48,312,24,24,0,0,0,0
72,-120,1,96,312,24,24,0,0,0,0
-48,-24,1,48,264,24,24,0,0,0,0
72,-24,1,96,264,24,24,0,0,0,0
-48,0,1,96,240,24,24,0,0,0,0
-24,-24,1,72,264,24,24,0,0,0,0
0,-24,1,72,264,24,24,0,0,0,0
24,-24,1,72,264,24,24,0,0,0,0
48,-24,1,72,264,24,24,0,0,0,0
-48,-96,1,48,288,24,24,0,0,0,0
-48,-72,1,48,288,24,24,0,0,0,0
-48,-48,1,48,288,24,24,0,0,0,0
-24,-120,1,72,312,24,24,0,0,0,0
0,-120,1,72,312,24,24,0,0,0,0
24,-120,1,72,312,24,24,0,0,0,0
48,-120,1,72,312,24,24,0,0,0,0
72,-96,1,96,288,24,24,0,0,0,0
72,-72,1,96,288,24,24,0,0,0,0
72,-48,1,96,288,24,24,0,0,0,0
24,-96,1,72,288,24,24,0,0,0,0
0,-96,1,72,288,24,24,0,0,0,0
-24,-96,1,72,288,24,24,0,0,0,0
-24,-72,1,72,288,24,24,0,0,0,0
0,-72,1,72,288,24,24,0,0,0,0
0,-48,1,72,288,24,24,0,0,0,0
24,-48,1,72,288,24,24,0,0,0,0
48,-48,1,72,288,24,24,0,0,0,0
48,-72,1,72,288,24,24,0,0,0,0
48,-96,1,72,288,24,24,0,0,0,0
24,-72,1,72,288,24,24,0,0,0,0
-24,-48,1,72,288,24,24,0,0,0,0
