assets/textures/tile_01.png
0,24
-72,-48,1,96,240,24,24,0,0,0,0
-72,96,1,96,240,24,24,0,0,0,0
-72,24,1,96,240,24,24,0,0,0,0
0,96,1,96,240,24,24,0,0,0,0
72,96,1,96,240,24,24,0,0,0,0
72,24,1,96,240,24,24,0,0,0,0
0,-48,1,96,240,24,24,0,0,0,0
72,-48,1,96,240,24,24,0,0,0,0
