10,17

11,8,8,8,8,8,8,8,8,8,8,8,8,8,8,9,0,
7,0,0,0,0,0,0,0,0,0,0,0,0,0,0,7,0,
7,0,0,0,0,0,0,0,0,0,0,0,0,0,0,7,0,
7,1,1,0,0,0,0,0,0,0,0,0,0,0,0,7,0,
5,3,12,1,1,1,0,0,0,1,1,1,0,0,0,7,0,
7,0,0,0,0,0,0,0,0,0,0,0,0,0,0,7,0,
7,0,0,0,0,0,0,0,0,0,0,0,0,0,1,7,0,
7,0,0,0,0,0,0,0,1,0,0,0,0,1,5,6,0,
7,1,1,1,0,0,0,1,7,1,1,1,1,5,2,6,0,
10,3,3,12,1,1,1,10,3,3,3,3,3,3,3,12,0,