assets/textures/tile_01.png
0,0
-96,32,1,128,160,32,32,0,0,0,0
-64,32,1,128,160,32,32,0,0,0,0
-32,32,1,128,160,32,32,0,0,0,0
0,32,1,128,160,32,32,0,0,0,0
32,32,1,128,160,32,32,0,0,0,0
64,32,1,128,160,32,32,0,0,0,0
96,32,1,128,160,32,32,0,0,0,0
128,32,1,128,160,32,32,0,0,0,0
160,32,1,128,160,32,32,0,0,0,0
64,-32,1,32,32,32,32,0,0,0,0
64,0,1,32,0,32,32,0,0,0,0
32,0,1,0,0,32,32,0,0,0,0
