assets/textures/tile_01.png
0,0
-32,-128,1,96,96,32,32,0,0,0,0
-96,0,1,128,160,32,32,0,0,0,0
0,-128,1,128,64,32,32,0,0,0,0
-128,32,1,128,128,32,32,0,0,0,0
-96,32,1,128,128,32,32,0,0,0,0
-64,32,1,128,128,32,32,0,0,0,0
-96,64,1,128,128,32,32,0,0,0,0
-128,64,1,128,128,32,32,0,0,0,0
-160,64,1,128,128,32,32,0,0,0,0
-192,64,1,128,128,32,32,0,0,0,0
-160,32,1,128,128,32,32,0,0,0,0
-64,64,1,128,128,32,32,0,0,0,0
32,-128,1,128,128,32,32,0,0,0,0
32,-160,1,128,128,32,32,0,0,0,0
-160,-224,1,128,128,32,32,0,0,0,0
-192,-224,1,128,128,32,32,0,0,0,0
-192,-192,1,128,128,32,32,0,0,0,0
-224,-192,1,128,128,32,32,0,0,0,0
-256,-192,1,128,128,32,32,0,0,0,0
96,-96,1,128,128,32,32,0,0,0,0
64,-128,1,128,128,32,32,0,0,0,0
64,-160,1,128,128,32,32,0,0,0,0
64,-192,1,128,128,32,32,0,0,0,0
32,-192,1,128,128,32,32,0,0,0,0
32,-224,1,128,128,32,32,0,0,0,0
-160,-256,1,128,128,32,32,0,0,0,0
-224,-224,1,128,128,32,32,0,0,0,0
-128,-256,1,128,128,32,32,0,0,0,0
-96,-256,1,128,128,32,32,0,0,0,0
-64,-256,1,128,128,32,32,0,0,0,0
-32,-256,1,128,128,32,32,0,0,0,0
0,-256,1,128,128,32,32,0,0,0,0
96,-192,1,128,128,32,32,0,0,0,0
96,-160,1,128,128,32,32,0,0,0,0
96,-128,1,128,128,32,32,0,0,0,0
-320,-160,1,128,128,32,32,0,0,0,0
-288,-192,1,128,128,32,32,0,0,0,0
-288,-224,1,128,128,32,32,0,0,0,0
-256,-224,1,128,128,32,32,0,0,0,0
-224,-256,1,128,128,32,32,0,0,0,0
-192,-256,1,128,128,32,32,0,0,0,0
32,-256,1,128,128,32,32,0,0,0,0
64,-256,1,128,128,32,32,0,0,0,0
64,-224,1,128,128,32,32,0,0,0,0
96,-224,1,128,128,32,32,0,0,0,0
128,-192,1,128,128,32,32,0,0,0,0
128,-160,1,128,128,32,32,0,0,0,0
128,-128,1,128,128,32,32,0,0,0,0
128,-96,1,128,128,32,32,0,0,0,0
-64,96,1,128,128,32,32,0,0,0,0
-96,96,1,128,128,32,32,0,0,0,0
-128,96,1,128,128,32,32,0,0,0,0
-160,96,1,128,128,32,32,0,0,0,0
-320,-192,1,128,128,32,32,0,0,0,0
-320,-224,1,128,128,32,32,0,0,0,0
-288,-256,1,128,128,32,32,0,0,0,0
-256,-256,1,128,128,32,32,0,0,0,0
-256,-288,1,128,128,32,32,0,0,0,0
-224,-288,1,128,128,32,32,0,0,0,0
-192,-288,1,128,128,32,32,0,0,0,0
-160,-288,1,128,128,32,32,0,0,0,0
-128,-288,1,128,128,32,32,0,0,0,0
-96,-288,1,128,128,32,32,0,0,0,0
-64,-288,1,128,128,32,32,0,0,0,0
-32,-288,1,128,128,32,32,0,0,0,0
0,-288,1,128,128,32,32,0,0,0,0
32,-288,1,128,128,32,32,0,0,0,0
64,-288,1,128,128,32,32,0,0,0,0
96,-288,1,128,128,32,32,0,0,0,0
128,-288,1,128,128,32,32,0,0,0,0
128,-256,1,128,128,32,32,0,0,0,0
160,-224,1,128,128,32,32,0,0,0,0
160,-192,1,128,128,32,32,0,0,0,0
160,-160,1,128,128,32,32,0,0,0,0
160,-128,1,128,128,32,32,0,0,0,0
128,-224,1,128,128,32,32,0,0,0,0
96,-256,1,128,128,32,32,0,0,0,0
160,-96,1,128,128,32,32,0,0,0,0
160,-64,1,128,128,32,32,0,0,0,0
160,-32,1,128,128,32,32,0,0,0,0
160,0,1,128,128,32,32,0,0,0,0
32,128,1,128,128,32,32,0,0,0,0
0,128,1,128,128,32,32,0,0,0,0
-32,128,1,128,128,32,32,0,0,0,0
-64,128,1,128,128,32,32,0,0,0,0
-96,128,1,128,128,32,32,0,0,0,0
-128,128,1,128,128,32,32,0,0,0,0
-160,128,1,128,128,32,32,0,0,0,0
-192,128,1,128,128,32,32,0,0,0,0
-224,128,1,128,128,32,32,0,0,0,0
-256,128,1,128,128,32,32,0,0,0,0
-256,96,1,128,128,32,32,0,0,0,0
-288,96,1,128,128,32,32,0,0,0,0
-224,96,1,128,128,32,32,0,0,0,0
-192,96,1,128,128,32,32,0,0,0,0
-320,32,1,128,128,32,32,0,0,0,0
-320,64,1,128,128,32,32,0,0,0,0
64,128,1,128,128,32,32,0,0,0,0
96,128,1,128,128,32,32,0,0,0,0
128,128,1,128,128,32,32,0,0,0,0
160,96,1,128,128,32,32,0,0,0,0
192,96,1,128,128,32,32,0,0,0,0
192,64,1,128,128,32,32,0,0,0,0
192,32,1,128,128,32,32,0,0,0,0
160,32,1,128,128,32,32,0,0,0,0
160,64,1,128,128,32,32,0,0,0,0
224,32,1,128,128,32,32,0,0,0,0
224,0,1,128,128,32,32,0,0,0,0
224,-32,1,128,128,32,32,0,0,0,0
224,-64,1,128,128,32,32,0,0,0,0
192,-64,1,128,128,32,32,0,0,0,0
192,-96,1,128,128,32,32,0,0,0,0
192,-128,1,128,128,32,32,0,0,0,0
192,-160,1,128,128,32,32,0,0,0,0
192,-192,1,128,128,32,32,0,0,0,0
192,-32,1,128,128,32,32,0,0,0,0
192,0,1,128,128,32,32,0,0,0,0
192,-224,1,128,128,32,32,0,0,0,0
192,-256,1,128,128,32,32,0,0,0,0
160,-288,1,128,128,32,32,0,0,0,0
160,-256,1,128,128,32,32,0,0,0,0
0,-320,1,128,128,32,32,0,0,0,0
-32,-320,1,128,128,32,32,0,0,0,0
-64,-320,1,128,128,32,32,0,0,0,0
-96,-320,1,128,128,32,32,0,0,0,0
-128,-320,1,128,128,32,32,0,0,0,0
-160,-320,1,128,128,32,32,0,0,0,0
-192,-320,1,128,128,32,32,0,0,0,0
-224,-320,1,128,128,32,32,0,0,0,0
-256,-320,1,128,128,32,32,0,0,0,0
-288,-320,1,128,128,32,32,0,0,0,0
-288,-288,1,128,128,32,32,0,0,0,0
-320,-288,1,128,128,32,32,0,0,0,0
-352,-288,1,128,128,32,32,0,0,0,0
-352,-256,1,128,128,32,32,0,0,0,0
-352,-224,1,128,128,32,32,0,0,0,0
-384,-224,1,128,128,32,32,0,0,0,0
-384,-192,1,128,128,32,32,0,0,0,0
-384,-160,1,128,128,32,32,0,0,0,0
-352,-192,1,128,128,32,32,0,0,0,0
-320,-256,1,128,128,32,32,0,0,0,0
-352,-160,1,128,128,32,32,0,0,0,0
-384,-128,1,128,128,32,32,0,0,0,0
-384,-96,1,128,128,32,32,0,0,0,0
-384,-64,1,128,128,32,32,0,0,0,0
-384,-32,1,128,128,32,32,0,0,0,0
-384,0,1,128,128,32,32,0,0,0,0
-416,0,1,128,128,32,32,0,0,0,0
-416,32,1,128,128,32,32,0,0,0,0
-416,64,1,128,128,32,32,0,0,0,0
-384,64,1,128,128,32,32,0,0,0,0
-384,32,1,128,128,32,32,0,0,0,0
-352,32,1,128,128,32,32,0,0,0,0
-352,64,1,128,128,32,32,0,0,0,0
-352,-96,1,128,128,32,32,0,0,0,0
-352,-128,1,128,128,32,32,0,0,0,0
-320,96,1,128,128,32,32,0,0,0,0
-288,128,1,128,128,32,32,0,0,0,0
-320,128,1,128,128,32,32,0,0,0,0
-416,-128,1,128,128,32,32,0,0,0,0
-416,-160,1,128,128,32,32,0,0,0,0
-416,-192,1,128,128,32,32,0,0,0,0
-416,-224,1,128,128,32,32,0,0,0,0
-416,-96,1,128,128,32,32,0,0,0,0
-416,-64,1,128,128,32,32,0,0,0,0
-416,-32,1,128,128,32,32,0,0,0,0
-352,96,1,128,128,32,32,0,0,0,0
-384,96,1,128,128,32,32,0,0,0,0
-160,-32,1,160,160,32,32,0,0,0,0
-192,-32,1,96,160,32,32,0,0,0,0
-192,0,1,96,128,32,32,0,0,0,0
-224,32,1,96,160,32,32,0,0,0,0
-256,64,1,128,160,32,32,0,0,0,0
-288,32,1,160,128,32,32,0,0,0,0
-288,0,1,160,160,32,32,0,0,0,0
-320,0,1,128,160,32,32,0,0,0,0
-352,-32,1,160,128,32,32,0,0,0,0
-320,-64,1,160,96,32,32,0,0,0,0
-320,-96,1,160,128,32,32,0,0,0,0
-288,-128,1,160,96,32,32,0,0,0,0
-256,-160,1,128,96,32,32,0,0,0,0
-224,-160,1,128,96,32,32,0,0,0,0
-192,-128,1,96,96,32,32,0,0,0,0
-160,-128,1,160,96,32,32,0,0,0,0
-160,-160,1,160,128,32,32,0,0,0,0
-128,-192,1,160,96,32,32,0,0,0,0
-96,-224,1,128,96,32,32,0,0,0,0
-32,-224,1,128,96,32,32,0,0,0,0
-64,-224,1,128,96,32,32,0,0,0,0
0,-192,1,96,128,32,32,0,0,0,0
-32,-160,1,96,160,32,32,0,0,0,0
32,-96,1,128,96,32,32,0,0,0,0
0,-96,1,96,96,32,32,0,0,0,0
64,-64,1,96,96,32,32,0,0,0,0
96,-32,1,96,96,32,32,0,0,0,0
128,0,1,96,128,32,32,0,0,0,0
128,32,1,96,128,32,32,0,0,0,0
128,64,1,96,128,32,32,0,0,0,0
96,96,1,128,160,32,32,0,0,0,0
64,96,1,128,160,32,32,0,0,0,0
32,96,1,128,160,32,32,0,0,0,0
0,96,1,128,160,32,32,0,0,0,0
-32,64,1,160,128,32,32,0,0,0,0
-32,32,1,160,128,32,32,0,0,0,0
-32,0,1,160,160,32,32,0,0,0,0
-64,0,1,128,160,32,32,0,0,0,0
-128,0,1,128,160,32,32,0,0,0,0
-352,-64,1,96,64,32,32,0,0,0,0
-320,-128,1,96,64,32,32,0,0,0,0
-288,-160,1,96,64,32,32,0,0,0,0
-160,-192,1,96,64,32,32,0,0,0,0
-128,-224,1,96,64,32,32,0,0,0,0
-192,-160,1,128,64,32,32,0,0,0,0
0,-224,1,128,64,32,32,0,0,0,0
64,-96,1,128,64,32,32,0,0,0,0
128,-32,1,128,64,32,32,0,0,0,0
96,-64,1,128,64,32,32,0,0,0,0
128,96,1,128,32,32,32,0,0,0,0
-224,64,1,128,32,32,32,0,0,0,0
-192,32,1,128,32,32,32,0,0,0,0
-352,0,1,96,32,32,32,0,0,0,0
-288,64,1,96,32,32,32,0,0,0,0
-160,0,1,96,32,32,32,0,0,0,0
-32,96,1,96,32,32,32,0,0,0,0
0,-160,1,128,32,32,32,0,0,0,0
128,-64,1,128,128,32,32,0,0,0,0
-416,96,1,128,128,32,32,0,0,0,0
-384,128,1,128,128,32,32,0,0,0,0
-352,128,1,128,128,32,32,0,0,0,0
-320,160,1,128,128,32,32,0,0,0,0
-288,160,1,128,128,32,32,0,0,0,0
-256,160,1,128,128,32,32,0,0,0,0
-224,160,1,128,128,32,32,0,0,0,0
-192,160,1,128,128,32,32,0,0,0,0
-160,160,1,128,128,32,32,0,0,0,0
-128,160,1,128,128,32,32,0,0,0,0
-128,192,1,128,128,32,32,0,0,0,0
-96,192,1,128,128,32,32,0,0,0,0
-96,160,1,128,128,32,32,0,0,0,0
-64,160,1,128,128,32,32,0,0,0,0
-32,160,1,128,128,32,32,0,0,0,0
0,160,1,128,128,32,32,0,0,0,0
32,160,1,128,128,32,32,0,0,0,0
64,160,1,128,128,32,32,0,0,0,0
96,160,1,128,128,32,32,0,0,0,0
128,160,1,128,128,32,32,0,0,0,0
160,160,1,128,128,32,32,0,0,0,0
160,128,1,128,128,32,32,0,0,0,0
0,192,1,128,128,32,32,0,0,0,0
-32,192,1,128,128,32,32,0,0,0,0
-64,192,1,128,128,32,32,0,0,0,0
-160,192,1,128,128,32,32,0,0,0,0
-192,192,1,128,128,32,32,0,0,0,0
-224,192,1,128,128,32,32,0,0,0,0
32,192,1,128,128,32,32,0,0,0,0
64,192,1,128,128,32,32,0,0,0,0
96,192,1,128,128,32,32,0,0,0,0
128,192,1,128,128,32,32,0,0,0,0
192,160,1,128,128,32,32,0,0,0,0
192,128,1,128,128,32,32,0,0,0,0
224,96,1,128,128,32,32,0,0,0,0
224,64,1,128,128,32,32,0,0,0,0
224,-96,1,128,128,32,32,0,0,0,0
224,-128,1,128,128,32,32,0,0,0,0
224,-160,1,128,128,32,32,0,0,0,0
256,-128,1,128,128,32,32,0,0,0,0
256,-96,1,128,128,32,32,0,0,0,0
256,-160,1,128,128,32,32,0,0,0,0
224,-192,1,128,128,32,32,0,0,0,0
224,-224,1,128,128,32,32,0,0,0,0
256,-64,1,128,128,32,32,0,0,0,0
256,-32,1,128,128,32,32,0,0,0,0
256,0,1,128,128,32,32,0,0,0,0
256,32,1,128,128,32,32,0,0,0,0
256,64,1,128,128,32,32,0,0,0,0
-448,-128,1,128,128,32,32,0,0,0,0
-448,-96,1,128,128,32,32,0,0,0,0
-448,-64,1,128,128,32,32,0,0,0,0
-448,-32,1,128,128,32,32,0,0,0,0
-448,0,1,128,128,32,32,0,0,0,0
-448,32,1,128,128,32,32,0,0,0,0
32,-320,1,128,128,32,32,0,0,0,0
